W,^,^,^,W,^,^,^,^,^,^,^,^,^,^,^,^,^,^,^,^,^,^,^,^,^,^,W,^
w,0,0,0,w,0,0,0,0,0,0,0,m,0,m,0,0,0,0,0,0,0,h,0,0,0,0,w,0
w,0,0,0,w,0,h,0,m,0,0,0,0,0,0,m,0,0,0,0,0,0,0,0,0,0,0,w,0
w,0,0,0,0,0,0,0,m,0,0,0,W,0,0,m,0,0,0,0,W,0,0,0,0,0,0,0,0
w,0,0,0,w,0,0,0,0,0,0,h,0,0,0,0,0,0,0,0,h,0,0,0,0,0,0,w,0
w,0,0,0,W,0,0,0,0,0,m,0,0,0,0,0,0,0,0,0,m,0,0,0,0,0,0,W,0