W,^,^,^,^,^,^,0,^,^,^,^,^,^,W
w,0,0,0,0,0,0,b,0,0,0,0,0,0,w
w,0,0,0,0,0,0,0,0,0,0,0,0,0,w
w,0,0,0,0,0,0,0,0,0,0,0,0,0,w
w,0,0,0,0,0,0,0,0,0,0,0,0,0,w
w,0,0,0,0,0,0,0,0,0,0,0,0,0,w
w,0,0,0,0,0,0,0,0,0,0,0,b,0,w
W,^,^,0,0,0,0,0,0,0,0,0,^,^,W
w,0,0,0,0,0,0,0,0,0,0,0,0,0,w
w,1,1,1,1,0,1,1,1,1,0,1,1,0,w
w,0,1,0,1,1,0,1,0,1,1,0,1,0,w
w,1,b,1,0,1,0,1,0,1,0,1,0,1,w
w,1,0,1,1,0,1,0,1,1,1,0,1,1,w
W,0,1,0,0,1,0,0,0,0,1,1,0,0,W