W,^,^,^,^,^,^,0,^,^,^,^,^,^,W
w,0,0,0,0,0,0,0,0,0,0,0,0,0,w
w,0,0,0,0,0,0,0,0,0,0,0,0,b,w
W,^,0,^,^,^,^,W,^,^,^,^,^,^,W
w,0,0,m,0,0,0,w,0,0,h,0,0,b,w
w,0,0,0,0,1,0,0,0,0,1,0,0,0,w
w,0,0,0,0,h,0,w,0,0,W,^,0,^,W
w,0,0,W,^,^,^,W,^,^,W,0,0,0,w
w,0,0,w,0,0,0,0,0,b,w,0,0,0,w
w,b,0,w,0,0,0,0,0,0,w,0,0,0,w
W,^,0,W,0,0,W,^,^,^,W,0,0,0,w
w,b,0,0,0,0,w,0,0,0,0,0,h,0,w
w,0,0,0,h,0,w,0,0,0,0,0,0,0,w
W,1,0,0,0,m,w,0,0,0,0,0,0,0,W