W,^,^,^,^,^,^,^,^,^,^,^,^,^,W
w,0,0,0,0,0,0,0,0,0,0,0,0,0,w
w,0,0,0,0,0,0,0,0,0,0,0,0,0,w
w,0,W,^,^,W,0,0,0,0,0,0,0,0,w
w,0,0,0,0,w,0,0,0,0,0,0,0,0,w
w,0,0,0,0,w,0,0,0,0,0,0,0,0,w
w,0,0,0,0,w,0,0,0,0,0,0,0,0,w
w,0,0,0,0,W,0,1,0,0,0,0,0,0,w
w,0,0,0,0,0,0,0,0,0,0,0,0,0,w
w,0,0,0,0,0,0,1,0,0,0,m,0,0,w
w,0,0,0,0,0,0,0,0,0,0,0,0,0,w
w,0,0,0,0,0,0,0,0,0,0,0,0,0,w
w,0,0,0,0,0,0,h,0,0,0,0,0,0,w
W,0,0,0,0,0,0,0,0,0,0,0,0,0,W