W,^,^,^,^,^,^,0,^,^,^,^,^,^,W
w,b,0,0,0,0,0,0,0,h,0,0,0,b,w
w,0,1,0,0,W,W,0,0,0,0,0,0,0,w
w,0,1,0,0,0,0,0,0,0,0,0,0,0,w
w,0,1,0,0,0,0,0,0,0,0,0,0,0,w
w,0,0,0,0,0,0,0,0,0,0,0,0,0,w
W,0,0,0,0,0,0,0,0,0,0,0,0,0,W
w,0,0,0,0,0,0,0,0,0,0,0,0,0,w
w,0,0,0,0,0,0,0,0,0,0,0,0,0,w
w,0,0,0,W,^,^,^,^,^,W,0,0,0,w
w,0,0,0,w,0,0,0,0,0,0,0,0,0,w
w,0,0,0,w,0,0,0,0,0,w,0,0,0,w
w,0,0,0,0,0,1,0,0,0,w,0,0,1,w
W,b,0,0,W,0,0,0,h,0,W,0,0,0,W