W,^,^,^,^,^,^,0,^,^,^,^,^,^,W
w,0,0,0,0,0,0,0,0,0,0,0,0,b,w
w,0,0,0,0,0,W,0,W,0,0,0,0,0,w
w,0,0,0,0,0,0,0,0,0,0,0,0,0,w
w,0,0,0,0,0,0,0,0,0,0,0,0,0,w
w,0,0,0,0,0,0,0,0,0,0,0,0,0,w
W,W,W,W,^,^,^,0,^,^,^,^,^,^,W
W,W,W,W,0,0,0,0,0,0,0,0,0,0,w
w,0,0,0,0,0,0,0,0,0,0,0,0,0,w
w,0,0,0,0,0,0,0,0,W,^,^,^,^,W
w,m,0,0,0,0,0,0,0,w,0,0,0,0,w
w,0,0,0,0,0,0,0,0,0,0,0,0,0,w
w,0,0,0,0,0,0,0,0,W,0,^,W,0,w
W,b,0,W,0,0,0,0,0,w,0,1,w,b,W