W,^,^,^,^,^,^,0,^,^,^,W,^,^,W
w,0,0,0,0,0,0,0,0,b,0,w,1,0,w
w,0,0,0,0,0,0,0,0,0,0,0,0,0,w
w,0,0,W,^,^,^,^,^,^,^,W,0,1,w
w,0,0,0,0,0,1,0,0,0,1,w,0,0,w
w,0,0,w,0,m,0,0,0,0,0,w,0,0,w
w,0,0,w,0,0,h,b,h,0,0,w,0,0,w
w,0,0,w,h,W,^,^,^,^,0,W,0,0,w
w,0,0,w,0,w,m,0,1,0,0,w,0,0,w
w,0,0,W,^,W,0,0,0,0,0,w,0,0,w
w,0,0,w,0,0,0,0,0,0,0,w,0,0,w
w,0,0,w,0,0,0,0,0,W,^,W,0,1,w
w,0,0,w,0,0,0,0,0,w,0,0,0,0,w
W,0,b,w,0,0,0,0,0,w,b,0,0,0,W