W,^,^,0,^,^,W,^,^,^,^,^,W
w,0,0,0,0,0,w,0,0,0,0,0,w
w,0,0,0,0,0,w,0,0,0,0,0,w
w,0,0,0,0,0,w,0,0,0,0,0,w
w,0,0,0,0,0,w,0,0,0,0,0,w
w,0,0,0,0,0,w,0,0,0,0,0,w
w,0,0,0,0,0,w,0,0,0,0,0,w
w,0,0,0,0,0,w,0,0,0,0,0,w
W,0,0,0,0,0,W,0,0,0,0,0,W