W,^,^,0,^,^,W
w,m,m,0,m,m,w
w,0,0,0,0,0,w
w,0,0,0,0,0,w
w,0,0,0,0,0,w
w,0,0,0,0,0,w
w,0,0,0,0,0,w
w,0,0,0,0,0,w
w,0,0,0,0,0,w
w,0,0,0,0,0,w
w,0,0,0,0,0,w
w,0,0,0,0,0,w
w,0,0,0,0,0,w
w,0,0,0,0,0,w
W,0,0,0,0,0,W