W,^,^,0,^,^,W
w,0,0,0,0,1,w
w,0,0,0,0,0,w
w,0,0,0,0,0,w
w,0,0,0,0,0,w
w,0,0,0,0,0,w
w,0,0,0,0,0,w
W,^,^,0,^,^,W
w,0,0,0,0,0,w
w,0,0,0,0,0,w
w,0,0,0,0,0,w
W,^,^,0,^,^,W
w,0,0,0,0,0,w
w,0,0,0,0,0,w
W,0,0,0,0,0,W