W,^,^,0,^,^,W,^,^,^,^,^,^,^,W
w,0,0,0,0,0,w,1,1,1,1,1,1,1,w
w,0,0,0,0,0,w,1,1,1,1,1,0,1,w
w,0,0,0,0,0,w,1,1,0,1,1,1,1,w
w,0,0,0,0,0,0,1,1,0,1,1,1,1,w
w,0,0,0,0,0,w,1,1,1,1,1,1,1,w
W,0,0,0,0,0,W,1,1,1,1,0,1,1,W